Deklarativno programiranje projekt
An Interactive Fiction by Nina
Release 1 / Serial number 250111 / Inform 7 build 6M62 (I6/v6.33 lib 6/12N) SD

Hello, this is Max's Journey: Lost in New York.  
 Welcome to an adventure through the bustling streets of New York City, as seen through the eyes of Max, a loyal dog who has lost his way. Max was separated from his owner during a stroll in the park, and now he must navigate the vibrant and sometimes overwhelming city to find his way back.

As Max, you'll sniff out clues, interact with colorful characters, and explore unique locations like parks, coffee shops, and bustling city squares. Along the way, you'll uncover the heartwarming story of friendship, determination, and the unbreakable bond between a dog and its owner.

Will Max's instincts guide him back to the one person who means the world to him? The journey begins now.

Park
It is a sunny afternoon, open park filled with people walking, playing, and relaxing on the grass. There are a few benches scattered around, and trees line the perimeter. For now, everything feels peaceful.

Max looks around, sniffing the air, his tail wagging with a sense of hope. He's lost, but he's not giving up.

You can also see Bench (on which is Note), Tree, a fountain (in which is water) and Jakov here.

>examine bench
The bench is worn but sturdy. A small note is pinned to it.

On Bench is a note.

>examine note
The note is a crumpled piece of paper with the words "Lost dog" written on it. There's a phone number scribbled at the bottom.

>examine tree
The tree's branches sway gently in the breeze, casting a patch of shade over the park. Nothing seems unusual about it, but Max senses something familiar about the scent of the leaves.

>examine Jakov
He is a jogger that runs every day in the Park. He seems very friendly but he run away.

>examine Max
You see nothing special about Max.

* * *

>e
You can't go that way.

>w
Coffee Shop
It is a cozy, bustling café with the warm aroma of freshly brewed coffee filling the air. Soft jazz music plays in the background, creating a calm ambiance.

You can see Ana, Menu and a dog biscuit here.

>e
Park
It is a sunny afternoon, open park filled with people walking, playing, and relaxing on the grass. There are a few benches scattered around, and trees line the perimeter. For now, everything feels peaceful.

Max looks around, sniffing the air, his tail wagging with a sense of hope. He's lost, but he's not giving up.

You can also see Max, Bench (on which is a note), Tree and Jakov here.

>examine jakov
He is a jogger that runs every day in the Park. He seems very friendly but he run away.

>w
Coffee Shop
You can see Menu here.

>look
Coffee Shop
You can see Menu here.

* * *

>w
Coffee Shop
It is a cozy, bustling café with the warm aroma of freshly brewed coffee filling the air. Soft jazz music plays in the background, creating a calm ambiance.

You can see Ana, Menu and a dog biscuit here.

>s
You can't go that way.

>w
You can't go that way.

>e
Park
It is a sunny afternoon, open park filled with people walking, playing, and relaxing on the grass. There are a few benches scattered around, and trees line the perimeter. For now, everything feels peaceful.

Max looks around, sniffing the air, his tail wagging with a sense of hope. He's lost, but he's not giving up.

You can also see Bench (on which is Note), Tree and Jakov here.

* * *

>w
Coffee Shop
It is a cozy, bustling café with the warm aroma of freshly brewed coffee filling the air. Soft jazz music plays in the background, creating a calm ambiance.

You can see Ana, Menu and a dog biscuit here.

>examine coffee shop
You can't see any such thing.

>examine Coffee Shop
You can't see any such thing.

>e
Park
It is a sunny afternoon, open park filled with people walking, playing, and relaxing on the grass. There are a few benches scattered around, and trees line the perimeter. For now, everything feels peaceful.

Max looks around, sniffing the air, his tail wagging with a sense of hope. He's lost, but he's not giving up.

You can also see Max, Bench (on which is a note), Tree and Jakov here.

>w
Coffee Shop
You can see Menu here.

>examine menu
The menu is a blackboard on the wall behind the counter, filled with various coffee blends and pastries. You see something written in chalk: "Special today: Dog-friendly lattes!"

I beg your pardon?

>e
Park
It is a sunny afternoon, open park filled with people walking, playing, and relaxing on the grass. There are a few benches scattered around, and trees line the perimeter. For now, everything feels peaceful.

Max looks around, sniffing the air, his tail wagging with a sense of hope. He's lost, but he's not giving up.

You can also see Max, Bench (on which is a note), Tree and Jakov here.

* * *

>w
Coffee Shop
It is a cozy, bustling café with the warm aroma of freshly brewed coffee filling the air. Soft jazz music plays in the background, creating a calm ambiance.

You can see Ana, Menu and a dog biscuit here.

>look
Coffee Shop
It is a cozy, bustling café with the warm aroma of freshly brewed coffee filling the air. Soft jazz music plays in the background, creating a calm ambiance.

You can see Menu here.

* * *

>w
Coffee Shop
It is a cozy, bustling café with the warm aroma of freshly brewed coffee filling the air. Soft jazz music plays in the background, creating a calm ambiance.

You can see Ana, Menu and a dog biscuit here.

>menu
That's not a verb I recognise.

>examine menu
The menu is a blackboard on the wall behind the counter, filled with various coffee blends and pastries. You see something written in chalk: "Special today: Dog-friendly lattes!"

* * *

>w
Coffee Shop
It is a cozy, bustling café with the warm aroma of freshly brewed coffee filling the air. Soft jazz music plays in the background, creating a calm ambiance.

You can see Ana, Menu and a dog biscuit here.

>examine dog biscuit
A small biscuit, shaped like a bone, the exact ones Max's owner gave him sits on the counter of the Coffee Shop. It's likely a treat for him for being a good dog.

>eat dog biscuit
(first taking the dog biscuit)
You eat the dog biscuit. Not bad.

>take dog biscuit
Taken.

* * *

>w
Coffee Shop
It is a cozy, bustling café with the warm aroma of freshly brewed coffee filling the air. Soft jazz music plays in the background, creating a calm ambiance.

You can see Ana, Menu and a dog biscuit here.

>e
Park
It is a sunny afternoon, open park filled with people walking, playing, and relaxing on the grass. There are a few benches scattered around, and trees line the perimeter. For now, everything feels peaceful.

Max looks around, sniffing the air, his tail wagging with a sense of hope. He's lost, but he's not giving up.

You can also see Bench (on which is Note), Tree and Jakov here.

>take key
You can't see any such thing.

>examine bench
The bench is worn but sturdy. A small note is pinned to it.

On Bench is a note.

* * *

>e
Park
It is a sunny afternoon, open park filled with people walking, playing, and relaxing on the grass. There are a few benches scattered around, and trees line the perimeter. For now, everything feels peaceful.

Max looks around, sniffing the air, his tail wagging with a sense of hope. He's lost, but he's not giving up.

You can also see Bench (on which is Note), Tree and Jakov here.

>examine note
The note is a crumpled piece of paper with the words "Lost dog" written on it. There's a phone number scribbled at the bottom.

* * *

>e
Park
It is a sunny afternoon, open park filled with people walking, playing, and relaxing on the grass. There are a few benches scattered around, and trees line the perimeter. For now, everything feels peaceful.

Max looks around, sniffing the air, his tail wagging with a sense of hope. He's lost, but he's not giving up.

You can also see Bench (on which is Note), Tree and Jakov here.

>s
Bakery
The air here is warm and sweet, filled with the rich aroma of freshly baked bread, cinnamon rolls, and pastries. The walls are painted a soft yellow. Small round tables with mismatched chairs are scattered throughout, each topped with a simple vase of fresh flowers. 

You can see Newsletter, Wooden table (closed) and an Oak front door here.

>s
(first opening the Oak front door)
It seems to be locked.

>n
Park
It is a sunny afternoon, open park filled with people walking, playing, and relaxing on the grass. There are a few benches scattered around, and trees line the perimeter. For now, everything feels peaceful.

Max looks around, sniffing the air, his tail wagging with a sense of hope. He's lost, but he's not giving up.

You can also see Max, Bench (on which is Note), Tree and Jakov here.

>s
Bakery
The air here is warm and sweet, filled with the rich aroma of freshly baked bread, cinnamon rolls, and pastries. The walls are painted a soft yellow. Small round tables with mismatched chairs are scattered throughout, each topped with a simple vase of fresh flowers. 

You can see Wooden table (closed) and an Oak front door here.

>open wooden table
You open Wooden table, revealing House key.

>take house key
Taken.

>s
(first opening the Oak front door)
It seems to be locked.

>unlock door with house key
You unlock the Oak front door.

* * *

>s
Bakery
The air here is warm and sweet, filled with the rich aroma of freshly baked bread, cinnamon rolls, and pastries. The walls are painted a soft yellow. Small round tables with mismatched chairs are scattered throughout, each topped with a simple vase of fresh flowers. 

You can see Newsletter, Wooden table (closed) and an Oak front door here.

>e
You can't go that way.

>n
Park
It is a sunny afternoon, open park filled with people walking, playing, and relaxing on the grass. There are a few benches scattered around, and trees line the perimeter. For now, everything feels peaceful.

Max looks around, sniffing the air, his tail wagging with a sense of hope. He's lost, but he's not giving up.

You can also see Max, Bench (on which is Note), Tree and Jakov here.

* * *

>s
Bakery
The air here is warm and sweet, filled with the rich aroma of freshly baked bread, cinnamon rolls, and pastries. The walls are painted a soft yellow. Small round tables with mismatched chairs are scattered throughout, each topped with a simple vase of fresh flowers. 

You can see Newsletter, Wooden table (closed) and an Oak front door here.

>open wooden table
You open Wooden table, revealing Unknown Item.

>take key
Taken.

>unlock door with key
You unlock the Oak front door.

>open door
You open the Oak front door.

>w
Apartment
A place where Max and his Owner live.

The End 

 The moment Max steps into the apartment, a wave of recognition washes over him. The warm, comforting scent of his owner lingers in the air. On the wall hangs a collage of photographs, many featuring Max and his owner, smiling and carefree. Everything here feels just right-this is where Max belongs 

.

>e
Bakery
The air here is warm and sweet, filled with the rich aroma of freshly baked bread, cinnamon rolls, and pastries. The walls are painted a soft yellow. Small round tables with mismatched chairs are scattered throughout, each topped with a simple vase of fresh flowers. 

You can see Newsletter, Wooden table (empty) and an Oak front door here.

* * *

>e
Park
It is a sunny afternoon, open park filled with people walking, playing, and relaxing on the grass. There are a few benches scattered around, and trees line the perimeter. For now, everything feels peaceful.

Max looks around, sniffing the air, his tail wagging with a sense of hope. He's lost, but he's not giving up.

You can also see Bench (on which is Note), Tree and Jakov here.

>w
Coffee Shop
It is a cozy, bustling café with the warm aroma of freshly brewed coffee filling the air. Soft jazz music plays in the background, creating a calm ambiance.

You can see Ana, Menu and a dog biscuit here.

>e
Park
It is a sunny afternoon, open park filled with people walking, playing, and relaxing on the grass. There are a few benches scattered around, and trees line the perimeter. For now, everything feels peaceful.

Max looks around, sniffing the air, his tail wagging with a sense of hope. He's lost, but he's not giving up.

You can also see Max, Bench (on which is Note), Tree and Jakov here.

* * *

>w
Coffee Shop
It is a cozy, bustling café with the warm aroma of freshly brewed coffee filling the air. Soft jazz music plays in the background, creating a calm ambiance.

You can see Ana, Menu and a dog biscuit here.

>w
You can't go that way.

>e
Park
It is a sunny afternoon, open park filled with people walking, playing, and relaxing on the grass. There are a few benches scattered around, and trees line the perimeter. For now, everything feels peaceful.

Max looks around, sniffing the air, his tail wagging with a sense of hope. He's lost, but he's not giving up.

You can also see Max, Bench (on which is Note), Tree and Jakov here.

* * *

>e
Park
It is a sunny afternoon, open park filled with people walking, playing, and relaxing on the grass. There are a few benches scattered around, and trees line the perimeter. For now, everything feels peaceful.

Max looks around, sniffing the air, his tail wagging with a sense of hope. He's lost, but he's not giving up.

You can also see Bench (on which is Note), Tree and Jakov here.

>e
You can't go that way.

* * *

>e
Park
It is a sunny afternoon, open park filled with people walking, playing, and relaxing on the grass. There are a few benches scattered around, and trees line the perimeter. For now, everything feels peaceful.

Max looks around, sniffing the air, his tail wagging with a sense of hope. He's lost, but he's not giving up.

You can also see Bench (on which is Note), Tree and Jakov here.

>n
You can't go that way.

>s
Bakery
The air here is warm and sweet, filled with the rich aroma of freshly baked bread, cinnamon rolls, and pastries. The walls are painted a soft yellow. Small round tables with mismatched chairs are scattered throughout, each topped with a simple vase of fresh flowers. 

You can see Newsletter, Wooden table (closed) and an Oak front door here.

>n
Park
It is a sunny afternoon, open park filled with people walking, playing, and relaxing on the grass. There are a few benches scattered around, and trees line the perimeter. For now, everything feels peaceful.

Max looks around, sniffing the air, his tail wagging with a sense of hope. He's lost, but he's not giving up.

You can also see Max, Bench (on which is Note), Tree and Jakov here.

>e
You can't go that way.

* * *

>w
Coffee Shop
It is a cozy, bustling café with the warm aroma of freshly brewed coffee filling the air. Soft jazz music plays in the background, creating a calm ambiance.

You can see Ana, Menu and a dog biscuit here.

>lie down
You find a warm, cozy corner by the fireplace and curl up. The soft murmur of conversation and the occasional clink of cups soothe you. This feels like a good place to rest for a while.

>examine menu
The menu is a blackboard on the wall behind the counter, filled with various coffee blends and pastries. You see something written in chalk: "Special today: Dog-friendly lattes!"

>taje menu
That's not a verb I recognise.

>take menu
Taken.

>e
Park
It is a sunny afternoon, open park filled with people walking, playing, and relaxing on the grass. There are a few benches scattered around, and trees line the perimeter. For now, everything feels peaceful.

Max looks around, sniffing the air, his tail wagging with a sense of hope. He's lost, but he's not giving up.

You can also see Bench (on which is Note), Tree and Jakov here.

* * *

>examine
What do you want to examine?

>examine bench
The bench is worn but sturdy. A small note is pinned to it.

On Bench is a note (on which is Key).

>examine key
Oh well done! You found the key to your apartment.

>w
Coffee Shop
It is a cozy, bustling café with the warm aroma of freshly brewed coffee filling the air. Soft jazz music plays in the background, creating a calm ambiance.

You can see Menu and a dog biscuit here.

>look
Coffee Shop
It is a cozy, bustling café with the warm aroma of freshly brewed coffee filling the air. Soft jazz music plays in the background, creating a calm ambiance.

You can see Menu and a dog biscuit here.

>e
Park
It is a sunny afternoon, open park filled with people walking, playing, and relaxing on the grass. There are a few benches scattered around, and trees line the perimeter. For now, everything feels peaceful.

Max looks around, sniffing the air, his tail wagging with a sense of hope. He's lost, but he's not giving up.

You can also see Max, Bench (on which is a note (on which is Key)), Tree and Jakov here.

>w
Coffee Shop
It is a cozy, bustling café with the warm aroma of freshly brewed coffee filling the air. Soft jazz music plays in the background, creating a calm ambiance.

You can see Menu and a dog biscuit here.

>e
Park
It is a sunny afternoon, open park filled with people walking, playing, and relaxing on the grass. There are a few benches scattered around, and trees line the perimeter. For now, everything feels peaceful.

Max looks around, sniffing the air, his tail wagging with a sense of hope. He's lost, but he's not giving up.

You can also see Max, Bench (on which is a note (on which is Key)), Tree and Jakov here.

>take keys
You can't see any such thing.

>take key
Taken.

>w
Coffee Shop
It is a cozy, bustling café with the warm aroma of freshly brewed coffee filling the air. Soft jazz music plays in the background, creating a calm ambiance.

You can see Max, Menu and a dog biscuit here.

* * *

>take note
Taken.

>w
Coffee Shop
It is a cozy, bustling café with the warm aroma of freshly brewed coffee filling the air. Soft jazz music plays in the background, creating a calm ambiance.

You can see Max, Ana, Menu and a dog biscuit here.

>eat dog biscuit
(first taking the dog biscuit)
You eat the dog biscuit. Not bad.

>n
You can't go that way.

>e
Park
It is a sunny afternoon, open park filled with people walking, playing, and relaxing on the grass. There are a few benches scattered around, and trees line the perimeter. For now, everything feels peaceful.

Max looks around, sniffing the air, his tail wagging with a sense of hope. He's lost, but he's not giving up.

You can also see Bench, Tree and Jakov here.

>n
You can't go that way.

>s
Bakery
The air here is warm and sweet, filled with the rich aroma of freshly baked bread, cinnamon rolls, and pastries. The walls are painted a soft yellow. Small round tables with mismatched chairs are scattered throughout, each topped with a simple vase of fresh flowers. 

You can see Wooden table (closed) here.

>open wooden table
You open Wooden table, revealing Key.

>take key
Taken.

>close wooden table
You close Wooden table.

* * *

>w
Coffee Shop
It is a cozy, bustling café with the warm aroma of freshly brewed coffee filling the air. Soft jazz music plays in the background, creating a calm ambiance.

You can see Max, Ana, Menu and a dog biscuit here.

>examine Ana
She's been working here for 5 years and she knows all the customers. She is very kind and polite.

>ask Ana about Hello
Oh! Hi, Max! I haven't seen you for a days. You look tired.

* * *

>ask ana about owner
Your owner has been looking for you everywhere. He left here a dog biscuit in a case you visit this Coffee Shop.

>eat dog biscuit
(first taking the dog biscuit)
You eat the dog biscuit. Not bad.

>s
You can't go that way.

>n
You can't go that way.

>w
You can't go that way.

>e
Park
It is a sunny afternoon, open park filled with people walking, playing, and relaxing on the grass. There are a few benches scattered around, and trees line the perimeter. For now, everything feels peaceful.

Max looks around, sniffing the air, his tail wagging with a sense of hope. He's lost, but he's not giving up.

You can also see Bench, Tree and Jakov here.

>s
Bakery
The air here is warm and sweet, filled with the rich aroma of freshly baked bread, cinnamon rolls, and pastries. The walls are painted a soft yellow. Small round tables with mismatched chairs are scattered throughout, each topped with a simple vase of fresh flowers. 

You can see Newsletter, Wooden table (closed) and an Oak front door here.

>examine vase
You can't see any such thing.

>open wooden table
You open Wooden table, revealing House key.

* * *

>take house key
Taken.

>unlock the oak front door
What do you want to unlock the Oak front door with?

>unlock door with key
You unlock the Oak front door.

>push
What do you want to push?

>w
You must name something more substantial.

>n
Park
It is a sunny afternoon, open park filled with people walking, playing, and relaxing on the grass. There are a few benches scattered around, and trees line the perimeter. For now, everything feels peaceful.

Max looks around, sniffing the air, his tail wagging with a sense of hope. He's lost, but he's not giving up.

You can also see Bench, Tree and Jakov here.

>push
What do you want to push?

>push key
Nothing obvious happens.

>push door
You can't see any such thing.

>bakery
That's not a verb I recognise.

>s
Bakery
The air here is warm and sweet, filled with the rich aroma of freshly baked bread, cinnamon rolls, and pastries. The walls are painted a soft yellow. Small round tables with mismatched chairs are scattered throughout, each topped with a simple vase of fresh flowers. 

You can see Newsletter, Wooden table (empty) and an Oak front door here.

>s
(first opening the Oak front door)
You can't, since the Oak front door leads nowhere.

>push door
It is fixed in place.

>unlock door with key
That's unlocked at the moment.

>unlock door with house key
That's unlocked at the moment.

>push door
It is fixed in place.

>push front door
It is fixed in place.

>push the front door
It is fixed in place.

>push newsletter
Nothing obvious happens.

>n
Park
It is a sunny afternoon, open park filled with people walking, playing, and relaxing on the grass. There are a few benches scattered around, and trees line the perimeter. For now, everything feels peaceful.

Max looks around, sniffing the air, his tail wagging with a sense of hope. He's lost, but he's not giving up.

You can also see Bench, Tree and Jakov here.

>s
Bakery
The air here is warm and sweet, filled with the rich aroma of freshly baked bread, cinnamon rolls, and pastries. The walls are painted a soft yellow. Small round tables with mismatched chairs are scattered throughout, each topped with a simple vase of fresh flowers. 

You can see Newsletter, Wooden table (empty) and an Oak front door here.

>push newsletter
Nothing obvious happens.

>push key
Nothing obvious happens.

>push
What do you want to push?

>newsletter
Nothing obvious happens.

>push vase
You can't see any such thing.

>push door
It is fixed in place.

>n
Park
It is a sunny afternoon, open park filled with people walking, playing, and relaxing on the grass. There are a few benches scattered around, and trees line the perimeter. For now, everything feels peaceful.

Max looks around, sniffing the air, his tail wagging with a sense of hope. He's lost, but he's not giving up.

You can also see Bench, Tree and Jakov here.

>push jakov
Jakov might not like that.

>push bench
It is fixed in place.

>push newsletter
You can't see any such thing.

>s
Bakery
The air here is warm and sweet, filled with the rich aroma of freshly baked bread, cinnamon rolls, and pastries. The walls are painted a soft yellow. Small round tables with mismatched chairs are scattered throughout, each topped with a simple vase of fresh flowers. 

You can see Newsletter, Wooden table (empty) and an Oak front door here.

>push newsltter
You can't see any such thing.

>push newsletter
Nothing obvious happens.

>push newsletter
Nothing obvious happens.

>push Newsletter
Nothing obvious happens.

>push Newsletter
Nothing obvious happens.

>n
Park
It is a sunny afternoon, open park filled with people walking, playing, and relaxing on the grass. There are a few benches scattered around, and trees line the perimeter. For now, everything feels peaceful.

Max looks around, sniffing the air, his tail wagging with a sense of hope. He's lost, but he's not giving up.

You can also see Bench, Tree and Jakov here.

>w
Coffee Shop
It is a cozy, bustling café with the warm aroma of freshly brewed coffee filling the air. Soft jazz music plays in the background, creating a calm ambiance.

You can see Max, Ana and Menu here.

>ask ana about
You could ask about Hello or Owner.

* * *

>take note
Taken.

>e
You can't go that way.

>w
Coffee Shop
It is a cozy, bustling café with the warm aroma of freshly brewed coffee filling the air. Soft jazz music plays in the background, creating a calm ambiance.

You can see Max, Ana, Menu and a dog biscuit here.

>ana
That's not a verb I recognise.

>Ana
That's not a verb I recognise.

>ask Ana about
I didn't understand that sentence.

>ask Ana about hello
There is no reply.

* * *

>s
Bakery
The air here is warm and sweet, filled with the rich aroma of freshly baked bread, cinnamon rolls, and pastries. The walls are painted a soft yellow. Small round tables with mismatched chairs are scattered throughout, each topped with a simple vase of fresh flowers. 

You can see Newsletter, Wooden table (closed) and an Oak front door here.

* * *

>n
Park
It is a sunny afternoon, open park filled with people walking, playing, and relaxing on the grass. There are a few benches scattered around, and trees line the perimeter. For now, everything feels peaceful.

Max looks around, sniffing the air, his tail wagging with a sense of hope. He's lost, but he's not giving up.

You can also see Max, Bench (on which is Note), Tree and Jakov here.

>w
Coffee Shop
It is a cozy, bustling café with the warm aroma of freshly brewed coffee filling the air. Soft jazz music plays in the background, creating a calm ambiance.

You can see Ana, Menu and a dog biscuit here.

>ask ana where is my owner
I didn't understand that sentence.

>ask ana about where is my owner
There is no reply.

>n
You can't go that way.

>s
You can't go that way.

* * *

>e
Park
It is a sunny afternoon, open park filled with people walking, playing, and relaxing on the grass. There are a few benches scattered around, and trees line the perimeter. For now, everything feels peaceful.

Max looks around, sniffing the air, his tail wagging with a sense of hope. He's lost, but he's not giving up.

You can also see Max, Bench (on which is Note), Tree and Jakov here.

>take note
Taken.

* * *

>w
Coffee Shop
It is a cozy, bustling café with the warm aroma of freshly brewed coffee filling the air. Soft jazz music plays in the background, creating a calm ambiance.

You can see Max, Ana, Menu and a dog biscuit here.

>ask ana about where is my owner
There is no reply.

>ask ana about hello
There is no reply.

* * *

>open wooden table
You open Wooden table, revealing Unknown Item.

>take house key
Taken.

>unlock oak front door
(with House key)
You unlock the Oak front door.

>open front door
You open the Oak front door.

>open front door
That's already open.

>close front dooe
I only understood you as far as wanting to close the Oak front door.

>close front door
You close the Oak front door.

>open front door
You open the Oak front door.

>s
You can't, since the Oak front door leads nowhere.

>n
Park
It is a sunny afternoon, open park filled with people walking, playing, and relaxing on the grass. There are a few benches scattered around, and trees line the perimeter. For now, everything feels peaceful.

Max looks around, sniffing the air, his tail wagging with a sense of hope. He's lost, but he's not giving up.

You can also see Max, Bench (on which is Note), Tree and Jakov here.

* * *

>take key
Taken.

>unlock front door
(with House key)
You unlock the Oak front door.

>open door
You open the Oak front door.

>execute apartment
That's not a verb I recognise.

* * *

>open wooden table
You open Wooden table, revealing Unknown Item.

>what is this thing
That's not a verb I recognise.

>examine unknown item
This is a house key. It looks like it could open the front door of a house. You wonder where it came from and who it belongs to.

>take unknown item
Taken.

* * *

>s
Bakery
The air here is warm and sweet, filled with the rich aroma of freshly baked bread, cinnamon rolls, and pastries. The walls are painted a soft yellow. Small round tables with mismatched chairs are scattered throughout, each topped with a simple vase of fresh flowers. 

You can see Newsletter, Wooden table (closed) and an Oak front door here.

>open table
You open Wooden table, revealing Unknown Item.

>take key
Taken.

>unlock door
(with House key)
You unlock the Oak front door.

>open door
You open the Oak front door.

>w
Apartment
The moment Max steps into the apartment, a wave of recognition washes over him. The warm, comforting scent of his owner lingers in the air. On the wall hangs a collage of photographs, many featuring Max and his owner, smiling and carefree. Everything here feels just right-this is where Max belongs.

You can see Max here.

>e
Bakery
The air here is warm and sweet, filled with the rich aroma of freshly baked bread, cinnamon rolls, and pastries. The walls are painted a soft yellow. Small round tables with mismatched chairs are scattered throughout, each topped with a simple vase of fresh flowers. 

You can see Newsletter, Wooden table (empty) and an Oak front door here.

>w
Apartment
The moment Max steps into the apartment, a wave of recognition washes over him. The warm, comforting scent of his owner lingers in the air. On the wall hangs a collage of photographs, many featuring Max and his owner, smiling and carefree. Everything here feels just right-this is where Max belongs.

You can see Max here.

* * *

>unlock door
(with House key)
You unlock the Oak front door.

>unlock door with key
That's unlocked at the moment.

>w
Apartment
The moment Max steps into the apartment, a wave of recognition washes over him. The warm, comforting scent of his owner lingers in the air. On the wall hangs a collage of photographs, many featuring Max and his owner, smiling and carefree. Everything here feels just right-this is where Max belongs.

You can see Owner here.

>ask owner about
You can't ask any questions.

>lock door with key
You can't see any such thing.

>open the door
You can't see any such thing.

>e
Bakery
The air here is warm and sweet, filled with the rich aroma of freshly baked bread, cinnamon rolls, and pastries. The walls are painted a soft yellow. Small round tables with mismatched chairs are scattered throughout, each topped with a simple vase of fresh flowers. 

You can see Newsletter, Wooden table (empty) and an Oak front door here.

>open the door
You open the Oak front door.

>w
Apartment
The moment Max steps into the apartment, a wave of recognition washes over him. The warm, comforting scent of his owner lingers in the air. On the wall hangs a collage of photographs, many featuring Max and his owner, smiling and carefree. Everything here feels just right-this is where Max belongs.

Max looks around, sniffing the air, his tail wagging with a sense of hope. He's lost, but he's not giving up.

You can also see Owner here.

>ask owner about
You can't ask any questions.

>ask owner about max
There is no reply.

>ask owner about Max
There is no reply.

>ask owner about dog biscuit
There is no reply.

* * *

>unlock door with key
You unlock the Oak front door.

>open door
The door creaks open. 
That's already open.

The End 

 The moment Max steps into the apartment, a wave of recognition washes over him. The warm, comforting scent of his owner lingers in the air. On the wall hangs a collage of photographs, many featuring Max and his owner, smiling and carefree. Everything here feels just right-this is where Max belongs 

.

>undo
Bakery
[Previous turn undone.]

>open table
That's already open.

>unlock door with key
That's unlocked at the moment.

>open door
The door creaks open. 
That's already open.

The End 

 The moment Max steps into the apartment, a wave of recognition washes over him. The warm, comforting scent of his owner lingers in the air. On the wall hangs a collage of photographs, many featuring Max and his owner, smiling and carefree. Everything here feels just right-this is where Max belongs 

.

* * *

>undo
Bakery
[Previous turn undone.]

>open door
The door creaks open. 
That's already open.

The End 

 The moment Max steps into the apartment, a wave of recognition washes over him. The warm, comforting scent of his owner lingers in the air. On the wall hangs a collage of photographs, many featuring Max and his owner, smiling and carefree. Everything here feels just right-this is where Max belongs 

.

>close door
You close the Oak front door.

>open door
The door creaks open. 
That's already open.

* * *

>open table
You open Wooden table, revealing Unknown Item.

>what is it
That's not a verb I recognise.

>examine unknown item
This is a house key. It looks like it could open the front door of a house. You wonder where it came from and who it belongs to.

* * *

>open table
You open Wooden table, revealing Unknown Item.

>take item
You can't see any such thing.

>examine unknown item
This is a house key. It looks like it could open the front door of a house. You wonder where it came from and who it belongs to.

* * *

>take unknown item
Taken.

>unlock door
(with Unknown Item)
You unlock the Oak front door.

>open door
You open the Oak front door.

* * *

>s
Bakery
The air here is warm and sweet, filled with the rich aroma of freshly baked bread, cinnamon rolls, and pastries. The walls are painted a soft yellow. Small round tables with mismatched chairs are scattered throughout, each topped with a simple vase of fresh flowers. 

You can see Newsletter, Wooden table (closed) and an Oak front door here.

>open tasble
You can't see any such thing.

>open table
You open Wooden table, revealing Unknown Item.

* * *

>take item
You can't see any such thing.

>take unknown item
Taken.

* * *

>s
Bakery
The air here is warm and sweet, filled with the rich aroma of freshly baked bread, cinnamon rolls, and pastries. The walls are painted a soft yellow. Small round tables with mismatched chairs are scattered throughout, each topped with a simple vase of fresh flowers. 

You can see Newsletter, Wooden table (closed) and an Oak front door here.

>open tabče
You can't see any such thing.

>open table
You open Wooden table, revealing Unknown Item.

* * *

>take item
You can't see any such thing.

>take key
Taken.

>unlock door
(with Unknown Item)
You unlock the Oak front door.

>unlock door with key
That's unlocked at the moment.

>open door
The door creaks open. You can now enter the apartment.

That's already open.

The End 

 The moment Max steps into the apartment, a wave of recognition washes over him. The warm, comforting scent of his owner lingers in the air. On the wall hangs a collage of photographs, many featuring Max and his owner, smiling and carefree. Everything here feels just right-this is where Max belongs 

.

>w
*** The End ***

Would you like to RESTART, RESTORE a saved game, QUIT or UNDO the last command?

>open door
Please give one of the answers above.

Would you like to RESTART, RESTORE a saved game, QUIT or UNDO the last command?

>undo
Bakery
[Previous turn undone.]

>open door
The door creaks open. You can now enter the apartment.

That's already open.

* * *

>n
You can't go that way.

* * *

>s
Bakery
The air here is warm and sweet, filled with the rich aroma of freshly baked bread, cinnamon rolls, and pastries. The walls are painted a soft yellow. Small round tables with mismatched chairs are scattered throughout, each topped with a simple vase of fresh flowers. 

You can see Newsletter, Wooden table (closed) and an Oak front door here.

>open wooden table
You open Wooden table, revealing House key.

* * *

>s
Bakery
The air here is warm and sweet, filled with the rich aroma of freshly baked bread, cinnamon rolls, and pastries. The walls are painted a soft yellow. Small round tables with mismatched chairs are scattered throughout, each topped with a simple vase of fresh flowers. 

You can see Newsletter, Wooden table (closed) and an Oak front door here.

>n
Park
It is a sunny afternoon, open park filled with people walking, playing, and relaxing on the grass. There are a few benches scattered around, and trees line the perimeter. For now, everything feels peaceful.

Max looks around, sniffing the air, his tail wagging with a sense of hope. He's lost, but he's not giving up.

You can also see Bench (on which is Note), Tree, a fountain (in which is water) and Jakov here.

* * *

>say hi to Jakov
"Hi there!" says Max to Jakov.
"Max, are you thirsty?" asks Jakov.

>yes
"Then you should drink from the fountain over there," Jakov suggests.

>go to coffee shop
You can't see any such thing.

>w
Coffee Shop
It is a cozy, bustling café with the warm aroma of freshly brewed coffee filling the air. Soft jazz music plays in the background, creating a calm ambiance.

You can see Ana, Menu and a dog biscuit here.

>ask Ana about Owner
Your owner has been looking for you everywhere. He left here a dog biscuit in a case you visit this Coffee Shop.

>e
Park
It is a sunny afternoon, open park filled with people walking, playing, and relaxing on the grass. There are a few benches scattered around, and trees line the perimeter. For now, everything feels peaceful.

Max looks around, sniffing the air, his tail wagging with a sense of hope. He's lost, but he's not giving up.

You can also see Bench (on which is Note), Tree, a fountain (in which is water) and Jakov here.

>s
Bakery
The air here is warm and sweet, filled with the rich aroma of freshly baked bread, cinnamon rolls, and pastries. The walls are painted a soft yellow. Small round tables with mismatched chairs are scattered throughout, each topped with a simple vase of fresh flowers. 

You can see Newsletter, Wooden table (closed) and an Oak front door here.

* * *

>open table
You open Wooden table, revealing Unknown Item.

>unknown item
That's not a verb I recognise.

>that is this thing
That's not a verb I recognise.

>what is this thing?
That's not a verb I recognise.

>examine unknown item
This is a house key. It looks like it could open the front door of a house. You wonder where it came from and who it belongs to.

>examine house key
This is a house key. It looks like it could open the front door of a house. You wonder where it came from and who it belongs to.

>take key
Taken.

* * *

>unlock door
(with Unknown Item)
You unlock the Oak front door.

>open door
The door creaks open 
.
The End

The moment Max steps into the apartment, a wave of recognition washes over him. The warm, comforting scent of his owner lingers in the air. On the wall hangs a collage of photographs, many featuring Max and his owner, smiling and carefree. Everything here feels just right-this is where Max belongs

.

    *** The End ***

Would you like to RESTART, RESTORE a saved game, QUIT or UNDO the last command?

* * *

>e
You can't go that way.

* * *

I beg your pardon?

>e
You can't go that way.

* * *

>examine fontaine
You can't see any such thing.

* * *

>examine fountain
A small fountain bubbles cheerfully. The water looks clean and drinkable.

In the fountain is water.

>drink watr
You can't see any such thing.

>drink water
Max laps up the cool water from the fountain. It feels refreshing!

>refill the fountain
The fountain is refilled. Max can drink again!

>examine jakov
He is a jogger that runs every day in the Park. He seems very friendly but he run away.

>say hi to jakov
"Hi there!" says Max to Jakov.
"Max, are you thirsty?" asks Jakov.

>yes
"Then you should drink from the fountain over there," Jakov suggests.

>no
That was a rhetorical question.

>say hi to jakov
"Hi there!" says Max to Jakov.
"Max, are you thirsty?" asks Jakov.

>no
"Alright, stay hydrated!" says Jakov before jogging away.

>examine fontain
You can't see any such thing.

>examine fountain
A small fountain bubbles cheerfully. The water looks clean and drinkable.

In the fountain is water.

>drink water
Max laps up the cool water from the fountain. It feels refreshing!

>drink water
Max laps up the cool water from the fountain. It feels refreshing!

>drink water
Max laps up the cool water from the fountain. It feels refreshing!
The fountain is now dry. There's no more water.

>refill fountain
The fountain is refilled. Max can drink again!

>refill the fountain
The fountain is refilled. Max can drink again!

>refill
The fountain is refilled. Max can drink again!

* * *

>examine max
You see nothing special about Max.

>examine tree
The tree's branches sway gently in the breeze, casting a patch of shade over the park. Nothing seems unusual about it, but Max senses something familiar about the scent of the leaves.

>examine fountain
A small fountain bubbles cheerfully. The water looks clean and drinkable.

In the fountain is water.

* * *

>drink water
Max laps up the cool water from the fountain. It feels refreshing!
The fountain is now dry. There's no more water.

>refill
The fountain is refilled. Max can drink again!

>examine jakov
He is a jogger that runs every day in the Park. He seems very friendly but he run away.

* * *

>no
"Alright, stay hydrated!" says Jakov before jogging away.

>say hi to jakov
"Hi there!" says Max to Jakov.
"Max, are you thirsty?" asks Jakov.

* * *

>yes
"Then you should drink from the fountain over there," Jakov suggests.

>examine bench
The bench is worn but sturdy. A small note is pinned to it.

On Bench is Note.

>look note
The note is a crumpled piece of paper with the words "Lost dog" written on it. There's a phone number scribbled at the bottom.

>take notw
You can't see any such thing.

>take note
Taken.

>w
Coffee Shop
It is a cozy, bustling café with the warm aroma of freshly brewed coffee filling the air. Soft jazz music plays in the background, creating a calm ambiance.

Max looks around, sniffing the air, his tail wagging with a sense of hope. He's lost, but he's not giving up.

You can also see Ana, Menu and a dog biscuit here.

>look menu
The menu is a blackboard on the wall behind the counter, filled with various coffee blends and pastries. You see something written in chalk: "Special today: Dog-friendly lattes!"

>examine ana
She's been working here for 5 years and she knows all the customers. She is very kind and polite.

>look ana
She's been working here for 5 years and she knows all the customers. She is very kind and polite.

* * *

>look menu
The menu is a blackboard on the wall behind the counter, filled with various coffee blends and pastries. You see something written in chalk: "Special today: Dog-friendly lattes!"

>lay down
You find a warm, cozy corner by the fireplace and curl up. The soft murmur of conversation and the occasional clink of cups soothe you. This feels like a good place to rest for a while.

>hello
That's not a verb I recognise.

>ask ana about hello
Oh! Hi, Max! I haven't seen you for a days. You look tired.

>ask ana about owner
Your owner has been looking for you everywhere. He left here a dog biscuit in a case you visit this Coffee Shop.

* * *

>s
You can't go that way.

>e
Park
It is a sunny afternoon, open park filled with people walking, playing, and relaxing on the grass. There are a few benches scattered around, and trees line the perimeter. For now, everything feels peaceful.

You can see Bench, Tree, a fountain (in which is water) and Jakov here.

>s
Bakery
The air here is warm and sweet, filled with the rich aroma of freshly baked bread, cinnamon rolls, and pastries. The walls are painted a soft yellow. Small round tables with mismatched chairs are scattered throughout, each topped with a simple vase of fresh flowers. 

You can see Newsletter, Wooden table (closed) and an Oak front door here.

>look newspaper
You can't see any such thing.

>look newsletter
The front page of today's newspaper immediately catches your eye. A large headline reads: "LOST DOG IN NEW YORK CITY." Beneath it, there's a photograph of a dog that looks remarkably like Max.

>open table
You open Wooden table, revealing Unknown Item.

>examine unknown item
This is a house key. It looks like it could open the front door of a house. You wonder where it came from and who it belongs to.

>take item
You can't see any such thing.

* * *

>take key
Taken.

>unlock door
What do you want to unlock the Oak front door with?

>unlock door with key
You unlock the Oak front door.

>lock door
What do you want to lock the Oak front door with?

>lock door with key
You lock the Oak front door.

>unlock door with key
You unlock the Oak front door.

>lock door with key
You lock the Oak front door.

>unlock front door with key
You unlock the Oak front door.

>lock door with key
You lock the Oak front door.

>unlock the front door with key
You unlock the Oak front door.